12 12 12 12 13 12 12 12 12 12 12 12 12 12 13 12 12 12 12 12 12 12 12 12 13 12 12 12 12 12 12 12 12 13 12 12 12 12 12 12 13 12 12 12 12 13 12 12 12 13
12 12 13 12 12 12 12 13 12 12 12 13 12 12 12 13 12 12 12 12 12 12 12 13 12 12 13 12 12 12 12 12 12 13 12 12 12 12 12 12 12 13 12 12 12 12 13 12 12 12 
12 12 12 12 12 13 12 12 13 12 12 12 12 13 12 12 12 12 12 12 12 12 12 12 12 12 12 13 12 12 13 12 12 12 12 12 12 13 12 12 12 12 12 13 12 12 12 12 13 12 
13 12 12 13 12 12 12 12 12 13 12 12 12 12 12 12 12 13 12 12 12 13 12 12 12 12 12 12 13 12 12 12 13 12 12 12 12 12 13 12 12 12 12 12 13 12 12 12 12 12 
12 13 12 12 12 12 12 12 12 12 12 13 12 12 12 12 12 12 13 12 12 12 13 12 12 12 13 12 12 12 12 12 12 12 13 12 12 12 12 13 12 12 13 12 12 12 12 12 12 12 
12 12 12 12 13 12 12 12 12 12 12 12 12 12 13 12 12 12 12 12 12 12 12 12 13 12 12 12 12 12 12 12 12 13 12 12 12 12 12 12 13 12 12 12 12 13 12 12 12 13
12 12 12 13 12 12 10 10 28 28 28 28 28 28 28 28 28 28 28 28 28 28 28 28 28 28 28 10 10 10 10 10 10 10 10 10 10 10 10 10 10 10 10 10 12 12 12 13 12 12
12 12 12 13 12 12 10 31 32 32 32 32 32 32 32 32 32 32 32 32 32 32 32 32 32 32 32 30 10 10 10 10 10 10 10 10 10 10 10 10 10 10 10 10 12 12 12 13 12 12
12 12 12 12 13 12 23 23 23 23 10 10 10 10 10 10 10 10 10 10 10 10 10 10 10 10 32 23 23 23 23 23 23 23 23 23 23 23 23 23 23 23 23 23 12 12 12 12 13 12
12 13 12 12 12 12 23 23 23 10 10 10 10 10 10 10 10 10 10 10 10 10 10 10 10 10 32 28 28 28 28 28 28 28 28 28 28 28 28 28 28 28 28 10 12 13 12 12 12 12
12 12 12 13 12 12 23 23 23 23 10 10 10 10 10 10 10 10 10 10 10 10 10 10 10 10 32 32 32 32 32 32 32 32 32 32 32 32 32 32 32 32 32 30 12 12 12 13 12 12
12 12 12 12 24 24 24 24 24 23 23 23 23 23 23 23 23 23 23 23 23 23 23 23 23 31 32 29 29 29 29 29 29 29 29 29 29 29 29 29 29 29 29 10 12 12 12 12 13 12
12 12 13 12 24 26 26 26 24 23 23 23 23 23 23 23 23 23 23 23 23 23 23 23 23 31 32 30 23 23 23 23 23 23 23 23 23 23 23 23 23 23 23 10 12 12 13 12 12 12
12 13 12 12 24 26 26 26 24 23 23 23 23 23 23 23 23 23 23 23 23 23 23 23 23 31 32 30 23 23 23 23 23 23 23 23 23 23 23 23 23 23 24 24 12 13 12 12 12 12
12 12 13 12 24 26 26 26 24 23 23 23 23 23 23 23 23 23 23 23 23 23 23 23 23 31 32 30 23 23 23 23 23 23 23 23 23 23 23 23 23 24 24 26 12 12 13 12 12 12
13 12 12 12 24 24 26 24 24 23 23 23 23 23 23 23 23 23 23 23 23 23 23 10 10 31 32 30 10 10 23 23 23 23 23 23 23 23 23 23 24 24 26 26 13 12 12 12 12 12
12 12 12 13 12 12 32 32 23 23 23 23 23 23 23 23 23 23 23 23 23 23 23 10 28 28 32 28 28 10 23 23 23 23 23 23 23 23 23 24 24 26 26 26 12 12 12 13 12 12
12 13 12 12 12 12 32 32 23 23 23 23 23 28 28 28 28 28 28 28 28 28 28 28 32 32 32 32 32 28 28 28 28 28 28 28 28 28 28 28 26 26 26 26 12 13 12 12 12 12
12 12 12 13 12 12 32 32 23 23 23 23 23 31 32 32 32 32 32 32 32 32 32 32 32 32 32 32 32 32 32 32 32 32 32 32 32 32 32 30 26 26 26 26 12 12 12 13 12 12
12 13 12 12 12 12 32 32 23 23 23 23 23 29 29 29 29 29 29 29 29 29 29 29 32 32 32 32 32 29 29 29 29 29 29 29 29 29 29 29 26 26 26 26 12 13 12 12 12 12
12 12 12 13 12 12 32 32 23 23 23 23 23 23 23 23 23 23 23 23 23 23 23 10 29 29 32 29 29 10 23 23 23 23 23 23 23 23 23 24 24 26 26 26 12 12 12 13 12 12
12 12 12 12 13 12 32 32 23 23 23 23 23 23 23 23 23 23 23 23 23 23 23 10 10 31 32 30 10 10 23 23 23 23 23 23 23 23 23 23 24 24 26 26 12 12 12 12 13 12
12 12 13 12 12 12 32 32 23 23 23 23 23 23 23 23 23 23 23 23 23 23 23 23 23 31 32 30 23 23 23 23 23 23 23 23 23 23 23 23 23 24 24 26 12 12 13 12 12 12
12 13 12 12 12 12 32 32 23 23 23 23 23 23 23 23 23 23 23 23 23 23 23 23 23 31 32 30 23 23 23 23 23 23 23 23 23 23 23 23 23 23 24 24 12 13 12 12 12 12
12 12 13 12 12 12 32 32 23 23 23 23 23 10 10 10 10 10 10 10 10 10 10 10 10 31 32 30 10 10 10 10 10 10 10 10 10 10 10 10 10 10 10 24 12 12 13 12 12 12
12 12 12 13 12 12 32 32 23 23 23 23 23 10 10 10 10 10 10 10 10 10 10 10 10 10 32 10 10 10 10 10 10 10 10 10 10 10 10 10 10 10 10 10 12 12 12 13 12 12
13 12 12 12 12 12 32 32 23 23 23 23 23 28 28 28 28 28 28 28 28 28 28 28 28 28 28 28 28 28 28 28 28 28 28 28 28 28 28 28 28 28 28 10 13 12 12 12 12 12
12 12 13 12 12 12 32 32 23 23 23 23 23 32 32 32 32 32 32 32 32 32 32 32 32 32 32 32 32 32 32 32 32 32 32 32 32 32 32 32 32 32 32 30 12 12 13 12 12 12
12 13 12 12 12 12 32 32 23 23 23 23 23 29 29 29 29 29 29 29 29 29 29 29 29 29 29 29 29 29 29 29 29 29 29 29 29 29 29 29 29 10 32 30 12 13 12 12 12 12
12 12 13 12 12 12 32 32 23 23 23 23 10 10 10 10 10 10 10 10 10 10 10 10 10 10 10 10 10 10 10 10 10 10 10 10 10 10 10 10 10 31 32 30 12 12 13 12 12 12
12 12 12 12 13 12 32 32 23 23 23 24 24 24 24 24 24 24 24 24 24 24 24 24 24 24 24 24 24 24 24 24 24 24 24 24 24 24 24 24 24 31 32 30 12 12 12 12 13 12
12 12 12 13 12 12 32 32 23 23 10 10 10 10 10 10 10 10 10 10 10 10 10 10 10 22 22 22 23 10 28 28 28 28 28 28 28 28 28 28 28 28 32 10 12 12 12 13 12 12
12 13 12 12 12 12 32 32 23 23 19 15 15 15 15 15 15 15 15 15 15 15 18 10 10 22 22 22 22 31 32 32 32 32 32 32 32 32 32 32 32 32 32 10 12 13 12 12 12 12
13 12 12 12 12 12 32 32 23 23 16 34 34 34 34 34 34 34 34 34 34 34 17 10 23 23 23 22 22 31 32 30 10 10 26 26 26 26 26 26 26 26 26 26 13 12 12 12 12 12
12 12 13 12 12 12 32 32 23 23 16 34 34 34 34 34 34 34 34 34 34 34 17 10 23 23 23 23 23 31 32 30 10 10 26 26 26 26 26 26 26 26 26 26 12 12 13 12 12 12
12 12 12 12 13 12 32 32 23 23 23 14 16 34 34 34 34 34 34 34 34 34 17 10 23 23 23 23 23 31 32 30 23 23 23 23 26 26 26 26 26 26 26 26 12 12 12 12 13 12
12 12 12 13 12 12 32 32 23 23 23 23 16 34 34 34 34 34 34 34 34 34 17 10 23 23 23 23 23 31 32 30 23 23 23 23 26 26 26 26 26 26 26 26 12 12 12 13 12 12  
12 12 13 12 12 12 32 32 23 23 23 23 16 34 34 34 34 34 34 34 34 34 17 10 23 23 23 23 23 31 32 30 23 23 23 23 26 26 26 26 26 26 26 26 12 12 13 12 12 12
12 12 12 12 12 13 32 32 23 23 23 23 21 14 14 14 14 14 14 14 14 14 20 10 23 23 23 23 23 31 32 30 23 23 23 23 26 26 26 26 26 26 26 26 12 12 12 12 12 13 
12 13 12 13 12 12 32 32 23 23 23 23 23 23 23 23 10 10 10 10 10 10 22 22 23 10 10 10 10 10 10 10 10 10 10 10 23 24 32 32 32 32 32 24 12 13 12 13 12 12
12 12 12 12 13 12 32 32 23 23 23 23 23 23 23 23 23 23 23 23 23 22 22 22 23 10 12 12 12 34 34 34 12 12 12 10 23 23 24 32 32 32 32 24 12 12 12 12 13 12
12 13 12 12 12 12 32 32 23 23 23 23 23 23 23 23 23 23 23 23 23 23 23 23 23 23 12 12 12 34 34 34 12 12 12 22 23 23 24 24 24 24 24 24 12 13 12 12 12 12
12 12 12 13 12 12 32 32 32 32 22 10 10 10 10 10 10 10 10 10 10 10 10 10 10 10 10 10 10 10 10 10 10 10 22 22 22 23 23 23 23 23 23 23 12 12 12 13 12 12
12 12 13 12 12 12 32 32 32 32 23 10 10 10 10 10 10 10 10 10 10 10 10 10 10 10 23 23 23 23 23 23 23 23 23 22 22 23 23 23 23 23 23 23 12 12 13 12 12 12
12 12 12 12 13 12 12 12 12 12 12 12 12 12 13 12 12 12 12 12 12 12 12 12 13 12 12 12 12 12 12 12 12 13 12 34 34 12 12 12 13 12 12 12 12 13 12 12 12 13
12 12 13 12 12 12 12 13 12 12 12 13 12 12 12 13 12 12 12 12 12 12 12 13 12 12 13 12 12 12 12 12 12 13 12 34 34 12 12 12 12 13 12 23 23 23 13 12 12 12 
12 12 12 12 12 13 12 12 13 12 12 12 12 13 12 12 12 12 12 12 12 12 12 12 12 12 12 13 12 12 13 12 12 12 12 34 34 34 34 34 34 34 23 10 10 23 12 12 13 12 
13 12 12 13 12 12 12 12 12 13 12 12 12 12 12 12 12 13 12 12 12 13 12 12 12 12 12 12 13 12 12 12 13 12 12 12 12 12 13 12 34 10 10 10 10 23 12 12 12 12 
12 13 12 12 12 12 12 12 12 12 12 13 12 12 12 12 12 12 13 12 12 12 13 12 12 12 13 12 12 12 12 12 12 12 13 12 12 12 12 23 10 10 10 10 23 12 12 12 12 12 
12 12 12 12 13 12 12 12 12 12 12 12 12 12 13 12 12 12 12 12 12 12 12 12 13 12 12 12 12 12 12 12 12 13 12 12 12 12 12 12 23 23 23 23 12 13 12 12 12 13